####################
#        ##    #####
### ####### ## #####
#           ## #####
######  ###### #####
####### ###### #####
##      ###        #
## ############## ##
## #     ######## ##
## ####       ### ##
## #### ######### ##
## ####           ##
##    ### ###### ###
## ###### ###### ###
## ##        ### ###
## ## #######    ###
## ## #     ### ####
## ## ##### ###    O
##            ######
####################
