++++++++++++++++++++
+                  +
+ +++++++++++ ++++++
+ +         +  +   +
+ + +++++++ + + ++ +
+ + +++++++ +++ ++ +
+ + +              O
+ + ++++++++++++++++
+ +                +
+ ++++++++ +++++++++
+ +         + + ++ +
+ + +++++++ +      +
+ + +     + + + ++ +
+   + +++++ + + ++ +
+ + +       + + ++ +
+ + +++++++++ + ++ +
+ +           + ++ +
+ +++++++++++++ ++ +
+                  +
++++++++++++++++++++
