@@@@@@@@@@@@@@@@@@@@
@  @@@@          @@@
@@ @@@@ @@@@ @@@ @@@
@@ @@@@ @@@@ @@@   @
@@      @@@@ @@@@@ @
@@ @@@@      @@@@  @
@@ @@@@@@@@@@@@@@ @@
@@   @@        @@  @
@@ @ @@ @@@@@@ @@@ @
@  @ @@  OO  @ @   @
@ @@ @@@@@@@ @ @ @@@
@  @ @@      @ @ @@@
@@ @   @@@@@@@ @   @
@@  @@@        @@@ @
@@@ @@@ @@@@ @@@@@ @
@@@ @@@ @@@@ @@@@  @
@@  @@@ @@@@ @@@@ @@
@@ @@@@ @@@@ @@@  @@
@@               @@@
@@@@@@@@@@@@@@@@@@@@
