^^^^^^^^^^^^^^^^^^^|
= ^^/+\/+\ /+++\^^^|
| ^/+++\++\+++++\^^|
|    ++++++\+++++\^|
|       +      +++\|
|     T % T        |
~~~~~~| % |~~   w  |
~~~~~~| % |~~~~ w  |
~~~~~~| % |~~~~~~  |
|     T % T   ~~~  |
|    w  w    ~~~  w|
|       www w~~~  O|
|w  wwwww    ~~~w  |
|   w   w www~~~~~ |
|     ww       ~~~~|
|   wwwwwwwwww   ~~|
|w       w    w   "|
|wwwwwww ww w w    |
|"          w    ww|
|""""""""""""""""""|
