VVVVVVVVVVVVVVVVVVVV
| |         ||||||||
| ||| |||||     ||||
|     ||||| ||| ||||
| |||||     | |    |
|  ||||||| || |||| |
||   ||||| ||      |
|||| ||||| |||||||||
||||           |||||
|||||||||| ||| |||||
||   ||||| | |   |||
|| |       | |||  ||
|  || |||| | |||| ||
| ||| ||||     ||  |
|     |||||||| ||| |
||| ||||   |||  || |
||| |||| | | |||  ||
|||      |        O|
|        |         |
^^^^^^^^^^^^^^^^^^^^
