********************
*    ***           *
**** **  ******** **
*O** *  ****    *  *
* **   *     ** ** *
* *** *********    *
* *** *   **********
* * *   *    **  ***
* * ******** *** ***
* *                *
* * ************** *
* * ************** *
* *            *** *
* * * * * * * **   *
* *            * ***
* * * * * * * ** ***
* *            *   *
* * ************** *
*                  *
********************
